16 16 
2 2 2 2 2 2 2 2 2 2 2 2 2 2 2 2 
2 3 3 3 3 3 3 3 3 3 2 2 2 2 2 2 
2 3 3 2 2 2 2 3 4 3 2 2 2 2 2 2 
2 2 2 2 2 2 2 3 3 3 2 2 2 2 2 2 
2 1 1 2 3 3 3 2 2 2 2 2 2 2 2 2 
2 1 1 2 3 3 3 2 2 2 2 2 2 2 2 2 
2 2 2 2 2 2 2 2 2 2 2 2 2 2 2 2 
2 2 2 2 2 2 2 2 2 2 2 2 2 2 2 2 
2 2 2 2 2 2 2 2 2 2 2 2 2 2 2 2 
2 2 2 2 2 2 2 2 2 2 2 2 2 2 2 2 
2 2 2 2 2 2 2 2 2 2 2 2 2 2 2 2 
2 2 2 2 2 2 2 2 2 2 2 2 2 2 2 2 
2 2 0 1 2 3 4 2 2 2 2 2 2 2 2 2 
2 2 4 3 2 1 0 2 2 2 2 2 2 2 2 2 
2 2 2 2 2 2 2 2 2 2 2 2 2 3 2 2 
2 2 2 2 2 2 2 2 2 2 2 2 2 2 2 2 
8 
3 0 0 140 260 1 2 
3 1 0 180 260 1 2 
3 2 0 220 260 1 2 
3 2 1 220 300 1 2 
3 2 2 220 340 1 2 
3 1 2 180 340 1 2 
3 0 2 140 340 1 2 
3 0 1 140 300 1 2 
