16 16 
2 2 2 2 2 2 2 2 2 2 2 2 2 2 2 2 
2 3 3 3 3 3 3 3 3 3 2 2 2 2 2 2 
2 3 3 2 2 2 2 3 4 3 2 2 2 2 2 2 
2 2 2 2 2 2 2 3 3 3 2 2 2 2 2 2 
2 1 1 2 3 3 3 2 2 2 2 2 2 2 2 2 
2 1 1 2 3 3 3 2 2 2 2 2 2 2 2 2 
2 2 2 2 2 2 2 2 2 2 2 2 2 2 2 2 
2 2 2 2 2 2 2 2 2 2 2 2 2 2 2 2 
2 2 2 2 2 2 2 2 2 2 2 2 2 2 2 2 
2 2 2 2 2 2 2 2 2 2 2 2 2 2 2 2 
2 2 2 2 2 2 2 2 2 2 2 2 2 2 2 2 
2 2 2 2 2 2 2 2 2 2 2 2 2 2 2 2 
2 2 0 1 2 3 4 2 2 2 2 2 2 2 2 2 
2 2 4 3 2 1 0 2 2 2 2 2 2 2 2 2 
2 2 2 2 2 2 2 2 2 2 2 2 2 3 2 2 
2 2 2 2 2 2 2 2 2 2 2 2 2 2 2 2 
4 
1 2 1 1 180 420 1 3 
1 2 2 1 220 420 1 3 
1 2 2 2 220 460 1 3 
1 2 1 2 180 460 1 3 
1 
1 2 4 3 2 1 0 
